1111111111111111
1111111111111111
111111PC0E011111
1111111111111111
1111111111111111
1111111111111111
1111111111111111
1111111111111111
1111111111111101
1111111111111111
1111111111111111
1111111111111111
1111111111111111
1111111111111111
1111111111111111
1111111111111111
1111111111111111