111111111111111111111111111111
1000000000000000C0000000000001
1000000000000P0000000100000001
100000000000000000000E00000001
111111111111111111111111111111