111111111111111
1E0000000000001
111001010010001
101001001010101
1P000000C00C011
111111111111111