111111111111111111111111111111
100000000000000000000000000001
1000C0000000PCE100000100000001
1000000C0000000C10000000000001
111111111111111111111111111111