1111111111111111111111111
1E000C000000000C000000001
101001010010000010C010101
1010010010101010000010101
1P000CC00C00C0000000000C1
1111111111111111111111111