1111111111111111111
100N000000C00000001
100000000NN00000001
1000111111111000001
10000C0C0C0C0000001
10000C0C0C0C000N001
10000C0C0C0C0000001
10000C0C0C0C0000001
10000C0C0P0C0000011
10000C0C0C0C0N00001
1N000C0C0C0C00000E1
1111111111111111111