111111111111111
100010010001011
101000000110111
111111111111111