11111111111111111111
1P000000C10000001001
1000010101110000C111
11000000010001010101
10001100000111100011
111011000000C0000111
10110110111100000111
11010110110000110111
10110100111000000111
10000010010001010111
11C00000110110100001
10101010000000100111
10101111101100000001
101000100001100000C1
101C1110000110100001
11C00000000000000111
110110110010000000E1
11111111000111011111
10100011010010101101
11111111111111111111