111111111111111111111111111111
100000000000000000000000000001
100000000000000000000000000001
100000000000000000000000000001
1000000CC00CCC0CCC0CCC00000001
10000000C0000C000C000C00000001
10000000C00CCC0CCC00C000000001
10000000C0000C000C00C000000001
1000000CCC0CCC0CCC00C000000001
100000000000000000000000000001
100000000000000000000000000001
1000000CC00CCC0CCC0CCC00000001
10000000C0000C000C000C00000001
10000000C00CCC0CCC00C000000001
10000000C0000C000C00C000000001
1000000CCC0CCC0CCC00C000000001
100000000000000000000000000001
100000000000000000000000000001
1000000CC00CCC0CCC0CCC00000001
10000000C0000C000C000C00000001
10000000C00CCC0CCC00C000000001
10000000C0000C000C00C000000001
1000000CCC0CCC0CCC00C000000001
1000000000000P0000000100000001
100000000000000000000000000001
100000000000000000000E00000001
111111111111111111111111111111