11111111111111111111111111111111111111111111
10000N00000N000000000N000000000000N00000E001
10C0000C0000CCCCCCCCCCCCCCCCCC0000C000000001
100000000000000N0000000000000N0000000N000001
10000N00000C00000000N000000N00C0000000000001
100C00000000C000N00000000000000000N00000C001
1000000P00000C00000000C0000N0000000C000N0001
11111111111111111111111111111111111111111111